contr|contributions|around
invi|invidious_copy.sh|file
new|newURL|around
invi|invidiousURL|file
newU|newURL|around
User|UserScript|around
evil|evil_status|around
BASE|BASEURL|around
BAS|BASEURL|around
rand|random_string|around
Credi|Credits|around
Demon|DemonKingSwarn|around
ytmenu|ytmenu|around
dependencies|dependencies|around
fzf|fzf|around
quer|query|around
INV|INVIDIOUS_URL|around
YOU|YOUTUBE_URL|around
IN|INVIDIOUS_URL|around
YO|YOUTUBE_URL|around
www|www|around
ytplay|ytplay|around
demonkingswarn|demonkingswarn|around
depend|dependencies|around
setbg|setbg|file
|cosmic-girl.jpg|file
per|permanent-wall|file
name|name|around
images|imagesaver|file
lock|lock.sh|file
loca|localhost|around
doas|doas|around
pla|playvideo|file
true|true|around
rec|recordings|around